11111111111111111111111111
1E00AC00A000000000A0000101
11100A10001A000000000101C1
1A1A00101011000A0000011101
1010001010A11000000000A101
1010CA10100011A00000000101
1010001010100110000A000001
10100010101C00110000000001
100C00001A0000011A000000P1
11111111111111111111111111