111111111111111
1000000000001P1
101111111110101
101C00A00C10001
1010000C0010001
1000A00A0010001
10100C00C010001
101111111110001
100000000000001
100000001111111
1000000000000E1
111111111111111