111111111111111111111111111111
1EA000000000000C00000C00000111
101111001110111000111100000111
101001001010101000100100000111
101001001010101000100100000111
101001001010101000100100000111
101001111011101111100100000111
1P0000000C00C00000000000000111
111111111111111111111111111111