11111111111111111111111111
1E00AC000000000010A0000101
11100010101A000010000101C1
1A1A0010101100001000011101
1010001010A110000000000101
1010CA10100011A00000000101
1010001010100111111A000001
10100010101C00000011000001
100C00000A00000000C11000P1
11111111111111111111111111