11111111111
1A00C0C1E01
1A000001101
1A000000001
1A000000001
1A000000001
1A000000001
1A0000000P1
11111111111