11111111111
1000C0000E1
1C000000111
1C0000000C1
11111000001
1C000000001
1C000000001
100000000P1
11111111111