11111111111111111111111111
1E000C00000000001000000101
111000101010000010000101C1
10100010101100001000011101
10100010100110000000000101
1010C010100011000000000101
10100010101001111110000001
10100010101C00000011000001
100C00000000000000C11000P1
11111111111111111111111111