111111111111111111111111111111111111111
100000001E00000C0000001C00000000C000001
101111111111111111111010111111111111101
101000P00C00C00000001010100000000000001
101011111111111111101010101111111111111
101010000C00C00000001010101C000000000C1
101010111111111111111010101011111111101
101010000000000000000010101C00000000101
1010111111111111111111101011111111111C1
100000000000000000000000100000000000001
111111111111111111111111111111111111111