111111111111111
1000000000001P1
101111011110101
101C00000C10101
1010000C0010001
100000000010001
1010000C0010001
101C00000C10001
101111111110001
100000000000001
100000001111111
1000000000000E1
111111111111111