11111111111
1A00C0C00E1
1C000111111
1C000000001
11111110001
1C000000001
1C000000001
1A0000000P1
11111111111