111111111111111
1A0000A0000A1P1
100000000000101
101111011110101
101C00A00C10001
1010000C0010001
100000000A10A01
1010A00C0010001
101C00A00C10101
101111111110101
100000000000101
101111A01111111
1000000000000E1
111111111111111