111111111111111111111111111111111111
1A00100A0100C0100001C00000000C00A0C1
1A0000C000000000A0010A1A01A01A000001
1001111111111111110100C00C0000111101
1001P0000C00C000C10101111111111A0001
1001111A0110A11A010101000A0A010A00C1
1001C0C00C000000010101010000010000C1
100101100110A110A1010101A01A01101111
1001C000A00000C000010101000001A00001
100111111111111111110101A0A0000000A1
1A0000000000A00000000101111111111111
10001000A100001C0000A100C000000000E1
111111111111111111111111111111111111