11111111111111111111111111111
1000AC000000000000A10A00001E1
10110010101A000010000000101C1
101A0010101100011111110011101
10A0001010A110001001010000101
1000CA10000011A00000A00100101
1010001010100111111A000100001
10100010101C00A1C011100111101
100C001010A00001000C1101A0001
10000010100000000000000100001
100000101A0011111111111100001
1011111011111C1A001C0A11111P1
101A000AC1001000000000000A111
100001000000000010000001000C1
100A000A00000000100010010A0C1
11111111111111111111111111111