1111111
1PC0001
1000001
1011111
100A001
10E0001
1111111