1111111
1PC00E1
1000001
1011111
10A0001
10000C1
1111111