111111111111111
10000000000A1P1
101111011110101
101C00A00C10101
1010000C0010001
100000000A10001
1010A00C0010001
101C00A00C10001
101111111110001
100000000000001
100000001111111
1000000000000E1
111111111111111