111111111111111111111
1A00000000A00000000A1
100011111000111110001
100010001000100010001
10001A1000001E1000001
1000100010A0100010001
100011111000111110001
1000000C00000C0000001
100011111111111110001
10001C000A00000C1C001
100011110001111110001
1P0000000000000000001
111111111111111111111