111111111111111111111111111111111111
1A00100A0100C0100001C00000000C00A0C1
1A0000C000000000A0010A1A01001A000001
1001111111111111110100C00C0000111101
1001P0000C00C000C10101111111111A0001
1001111A0110A11A010101000000000000C1
1001C0C00C00000001010101111010A000C1
100101100110A110A1010100000011011111
1001C000A00000C00001010101111A000001
10011111111111111111010100000A000001
1A0000000000A00000000101111111111111
10001000A100001C0000A100C000000000E1
111111111111111111111111111111111111