111111111111111111111111111111111111
1A0000000000C0000001C0A000000C0000C1
1A0000C000000000A001001A01001A000001
1001111111111111110100000A00A0111101
1001P0000C00C00001010111111111100001
1001111111A11111010101000000000000C1
100100C00C00000001010101111A100000C1
100101111111111111010101000011A11111
100100000000000000010101011110000001
100111111111111111110101000000000001
1A0000000000000000000101111111111111
100000000000000000000100C000000000E1
111111111111111111111111111111111111