111111111111111111111
100000000000000000001
100011111000111110001
10001C0010001C0010001
1000101C00001E1C00001
10001C0010001C0010001
100011111000111110001
1000000C00000C0000001
100011111111111110001
10001C000000000C10001
100011110001111110001
1P0000000000000000001
111111111111111111111